1111111111111111111111111111111111
1E000000000000000001C1000000000001
1010010100100000101100000000010101
1010010010101010001001000000010101
1P00000000000000000000000000000001
1111111111111111111111111111111111