1111111111111
10010000C00C1
1000011111001
1P00111E0C001
1111111111111
